#######
#S#...#
#...#.#
##.#.##
#....E#
#######
