S........#######
#######..#######
#........#......
#.###.#.###.####
#.#.#.#.....#..#
#.#.#.#####.#.##
#.#.#.....#.#..#
#.#.#####.#.##.#
#...#...#.#....#
#####.#.#.######
#.....#.#......#
#.##########.#.#
#.#..........#.#
#.#.##########.#
#.#............#
##############.E
